16,16

00,01,01,01,01,01,01,01,01,01,01,01,01,05,01,01
01,01,01,01,01,01,01,01,01,05,05,01,01,05,05,02
01,01,00,01,01,01,01,01,05,05,05,05,05,05,05,02
01,01,00,00,00,01,01,00,05,05,05,05,05,05,05,02
01,01,01,01,00,01,01,00,01,00,00,00,00,05,05,02
01,01,01,00,00,01,00,00,00,00,00,00,00,05,05,01
01,01,01,01,01,01,00,00,00,00,00,00,05,05,05,01
01,01,01,01,01,00,00,00,00,00,00,01,01,05,01,01
01,01,01,01,01,00,00,00,00,00,01,01,01,05,01,05
01,01,01,01,01,00,00,00,00,01,01,01,01,05,05,05
01,01,01,01,01,01,01,01,01,01,01,01,01,01,05,05
01,01,01,01,01,01,01,01,01,01,01,01,01,01,05,05
01,01,01,01,01,01,01,01,01,01,01,01,05,05,05,05
01,01,01,01,01,01,01,01,01,01,05,05,05,05,05,05
01,01,01,05,05,05,05,05,05,05,05,05,05,05,05,05
01,05,05,05,05,05,05,05,05,05,05,05,05,05,05,05

0,0,0,0,0,0,0,0,0,0,0,0,0,0,0,0
0,0,0,0,0,0,0,0,0,0,0,0,0,0,0,0
0,0,0,0,0,0,0,0,0,0,0,0,0,0,0,0
0,0,0,0,0,0,0,0,0,0,0,0,0,0,0,0
0,0,0,0,0,0,0,0,0,0,0,0,0,0,0,0
1,0,0,0,0,0,0,0,0,0,0,0,0,0,0,1
1,0,0,0,0,0,0,0,0,0,0,0,0,0,0,1
1,0,0,0,0,0,0,0,0,0,0,0,0,0,0,1
0,1,1,1,0,0,0,0,0,0,0,0,1,1,1,0
0,0,0,1,1,1,1,1,1,1,1,1,0,0,0,0
0,0,0,0,0,0,0,0,0,0,0,0,0,0,0,0
0,0,0,0,0,0,0,0,0,0,0,0,0,0,0,0
0,0,0,0,0,0,0,0,0,0,0,0,0,0,0,0
0,0,0,0,0,0,0,0,0,0,0,0,0,0,0,0
0,0,0,0,0,0,0,0,0,0,0,0,0,0,0,0
0,0,0,0,0,0,0,0,0,0,0,0,0,0,0,0


